27	72
32	32
8	41	38	43	42	38	42	41	38	42	42	36	37	42	41	38	42	42	41	38	41	42	41	38	41	42	41	38	41	42	41	38	0	0	0	0	0	0	0	0	0	0	0	0	0	0	0	0	0	0	0	0	0	0	0	0	0	0	0	0	0	0	0	0	0	0	0	0	0	0	0	0	
8	42	38	165	165	38	165	42	38	43	31	44	45	31	42	38	43	31	42	38	42	31	42	38	42	165	42	38	42	165	42	38	0	0	0	0	0	0	0	0	0	0	0	0	0	0	0	0	0	0	0	0	0	0	0	0	0	0	0	0	0	0	0	0	0	0	0	0	0	0	0	0	
8	43	38	165	165	38	31	165	38	36	37	31	31	36	37	38	165	36	37	38	43	36	37	38	43	36	37	38	43	165	165	38	0	0	0	0	0	0	0	0	0	0	0	0	0	0	0	0	0	0	0	0	0	0	0	0	0	0	0	0	0	0	0	0	0	0	0	0	0	0	0	0	
16	31	38	165	165	38	39	28	38	44	45	39	39	44	45	38	31	44	45	38	31	44	45	38	31	44	45	38	165	165	165	38	0	0	0	0	0	0	0	0	0	0	0	0	0	0	0	0	0	0	0	0	0	0	0	0	0	0	0	0	0	0	0	0	0	0	0	0	0	0	0	0	
24	39	13	13	13	13	39	8	38	31	31	39	39	31	31	38	39	31	31	38	39	31	31	38	39	31	31	38	31	31	31	38	0	0	0	0	0	0	0	0	0	0	0	0	0	0	0	0	0	0	0	0	0	0	0	0	0	0	0	0	0	0	0	0	0	0	0	0	0	0	0	0	
1	1	1	1	1	1	1	1	1	1	1	1	1	1	1	1	1	1	1	1	1	1	1	1	1	1	1	1	1	12	1	1	0	0	0	0	0	0	0	0	0	0	0	0	0	0	0	0	0	0	0	0	0	0	0	0	0	0	0	0	0	0	0	0	0	0	0	0	0	0	0	0	
0	0	0	0	0	0	0	0	0	0	0	0	0	0	0	0	0	0	0	0	0	0	0	0	0	0	0	0	0	0	0	0	0	0	0	0	0	0	0	0	0	0	0	0	0	0	0	0	0	0	0	0	0	0	0	0	0	0	0	0	0	0	0	0	0	0	0	0	0	0	0	0	
0	0	0	0	0	0	0	0	0	0	0	0	0	0	0	0	8	22	2	27	26	22	27	27	22	22	22	27	26	11	7	1	1	22	22	26	27	22	27	22	22	27	27	26	27	22	27	34	26	8	34	34	34	8	32	32	1	22	23	22	23	27	22	26	22	27	23	26	23	22	23	8	
0	0	0	0	0	0	0	0	0	0	0	0	0	0	0	0	8	2	23	26	3	3	27	27	27	27	27	27	11	19	23	1	1	27	27	22	26	27	22	27	27	27	27	26	28	28	28	28	27	8	32	32	32	8	40	40	1	6	27	27	27	27	26	27	27	27	27	33	33	33	27	8	
0	0	0	0	0	0	0	0	0	0	0	0	0	0	0	0	1	13	15	28	28	28	28	24	13	13	13	13	13	13	13	1	1	28	15	28	28	28	28	28	1	28	28	14	29	30	30	29	21	8	40	40	40	8	28	13	25	13	13	15	28	28	28	28	1	25	28	28	28	28	12	25	
0	0	0	0	0	0	0	0	0	0	0	0	0	0	0	0	1	2	2	14	3	3	22	8	27	27	23	27	26	2	2	2	16	22	22	14	22	22	22	22	1	3	3	22	14	29	29	29	20	25	165	165	165	25	14	26	8	165	165	165	14	165	29	29	1	8	23	22	26	11	22	8	
0	0	0	0	0	0	0	0	0	0	0	0	0	0	0	0	1	4	22	22	14	27	27	8	26	27	26	2	27	6	26	26	24	22	22	22	14	22	22	22	1	3	3	19	27	13	2	23	19	8	35	35	35	8	3	14	8	35	35	35	22	1	30	30	1	8	22	27	11	3	3	8	
0	0	0	0	0	0	0	0	0	0	0	0	0	0	0	0	1	1	1	1	1	1	1	1	1	1	1	1	1	1	1	1	1	1	1	1	1	1	1	1	1	1	1	1	1	1	1	1	1	1	1	1	1	1	1	1	1	1	1	1	1	1	1	1	1	1	12	1	1	1	1	1	
0	0	0	0	0	0	0	0	0	0	0	0	0	0	0	0	0	0	0	0	0	0	0	0	0	0	0	0	0	0	0	0	0	0	0	0	0	0	0	0	0	0	0	0	0	0	0	0	0	0	0	0	0	0	0	0	0	0	0	0	0	0	0	0	0	0	0	0	0	0	0	0	
0	0	0	0	0	0	0	0	0	0	0	0	0	0	0	0	0	0	0	0	0	0	0	0	8	9	10	4	7	2	4	2	7	7	7	2	4	1	8	7	8	7	7	7	7	7	2	7	8	7	7	2	2	7	7	8	7	7	3	2	3	7	8	1	8	3	11	22	27	3	22	8	
0	0	0	0	0	0	0	0	0	0	0	0	0	0	0	0	0	0	0	0	0	0	0	0	8	17	18	5	7	4	6	21	6	6	2	2	6	1	8	2	8	2	7	2	2	2	7	7	8	2	2	2	2	7	2	8	2	2	13	13	13	13	8	1	8	11	22	27	22	22	27	8	
0	0	0	0	0	0	0	0	0	0	0	0	0	0	0	0	0	0	0	0	0	0	0	0	13	13	13	13	15	13	13	13	13	13	1	15	13	13	8	7	8	2	9	3	3	10	7	2	8	7	9	3	3	10	7	8	6	2	21	21	4	2	8	1	1	13	25	14	26	27	22	8	
0	0	0	0	0	0	0	0	0	0	0	0	0	0	0	0	0	0	0	0	0	0	0	0	4	7	2	7	7	14	7	7	7	7	1	7	14	7	8	7	8	4	17	3	3	18	2	4	8	4	17	3	3	18	2	8	13	4	20	20	6	4	8	16	13	23	8	27	13	12	13	8	
0	0	0	0	0	0	0	0	0	0	0	0	0	0	0	0	0	0	0	0	0	0	0	0	6	5	13	13	5	13	13	2	7	5	1	2	2	1	1	2	8	5	17	3	3	18	21	6	8	5	17	3	3	18	6	8	6	19	1	1	1	19	8	24	22	22	8	26	11	22	27	8	
0	0	0	0	0	0	0	0	0	0	0	0	0	0	0	0	0	0	0	0	0	0	0	0	1	1	15	1	1	1	1	1	1	1	1	1	1	1	1	1	1	1	1	1	1	1	1	1	1	1	1	1	1	1	1	1	1	1	1	1	1	1	1	1	1	1	1	1	1	1	1	1	
0	0	0	0	0	0	0	0	0	0	0	0	0	0	0	0	0	0	0	0	0	0	0	0	0	0	0	0	0	0	0	0	0	0	0	0	0	0	0	0	0	0	0	0	0	0	0	0	0	0	0	0	0	0	0	0	0	0	0	0	0	0	0	0	0	0	0	0	0	0	0	0	
0	0	0	0	0	0	0	0	0	0	0	0	0	0	0	0	0	0	0	0	0	0	0	0	8	7	14	2	7	7	7	7	9	10	4	9	10	7	2	8	0	0	0	0	0	0	0	0	0	0	0	0	0	0	0	0	0	0	0	0	0	0	0	0	0	0	0	0	0	0	0	0	
0	0	0	0	0	0	0	0	0	0	0	0	0	0	0	0	0	0	0	0	0	0	0	0	8	5	7	14	2	5	2	6	17	18	5	17	18	2	7	8	0	0	0	0	0	0	0	0	0	0	0	0	0	0	0	0	0	0	0	0	0	0	0	0	0	0	0	0	0	0	0	0	
0	0	0	0	0	0	0	0	0	0	0	0	0	0	0	0	0	0	0	0	0	0	0	0	13	13	13	13	13	13	13	13	13	13	13	13	13	14	5	8	0	0	0	0	0	0	0	0	0	0	0	0	0	0	0	0	0	0	0	0	0	0	0	0	0	0	0	0	0	0	0	0	
0	0	0	0	0	0	0	0	0	0	0	0	0	0	0	0	0	0	0	0	0	0	0	0	7	2	7	9	10	2	4	7	4	9	10	2	2	11	13	13	0	0	0	0	0	0	0	0	0	0	0	0	0	0	0	0	0	0	0	0	0	0	0	0	0	0	0	0	0	0	0	0	
0	0	0	0	0	0	0	0	0	0	0	0	0	0	0	0	0	0	0	0	0	0	0	0	2	3	4	17	18	5	5	2	6	17	18	7	11	2	5	6	0	0	0	0	0	0	0	0	0	0	0	0	0	0	0	0	0	0	0	0	0	0	0	0	0	0	0	0	0	0	0	0	
0	0	0	0	0	0	0	0	0	0	0	0	0	0	0	0	0	0	0	0	0	0	0	0	1	1	1	1	1	1	1	1	1	1	1	1	1	1	1	1	0	0	0	0	0	0	0	0	0	0	0	0	0	0	0	0	0	0	0	0	0	0	0	0	0	0	0	0	0	0	0	0