81	27
32	32
77	85	72	85	72	85	72	77	81	77	79	77	64	77	79	77	69	65	86	86	70	71	65	0	0	0	0	0	0	0	0	0	0	0	0	0	0	0	0	0	0	0	0	0	0	0	0	0	0	0	0	0	0	0	0	0	0	0	0	0	0	0	0	0	0	0	0	0	0	0	0	0	0	0	0	0	0	0	0	0	0	
77	85	80	85	80	85	80	77	81	77	72	77	72	77	72	77	69	73	86	86	68	67	73	0	0	0	0	0	0	0	0	0	0	0	0	0	0	0	0	0	0	0	0	0	0	0	0	0	0	0	0	0	0	0	0	0	0	0	0	0	0	0	0	0	0	0	0	0	0	0	0	0	0	0	0	0	0	0	0	0	0	
77	85	80	85	80	85	80	77	81	77	80	77	80	77	80	77	59	57	86	87	76	75	64	0	0	0	0	0	0	0	0	0	0	0	0	0	0	0	0	0	0	0	0	0	0	0	0	0	0	0	0	0	0	0	0	0	0	0	0	0	0	0	0	0	0	0	0	0	0	0	0	0	0	0	0	0	0	0	0	0	0	
77	85	80	85	80	85	80	77	85	77	80	77	80	77	80	77	85	86	94	95	86	66	60	0	0	0	0	0	0	0	0	0	0	0	0	0	0	0	0	0	0	0	0	0	0	0	0	0	0	0	0	0	0	0	0	0	0	0	0	0	0	0	0	0	0	0	0	0	0	0	0	0	0	0	0	0	0	0	0	0	0	
77	85	85	82	83	84	85	77	85	77	80	77	80	77	55	55	55	61	86	86	86	74	59	0	0	0	0	0	0	0	0	0	0	0	0	0	0	0	0	0	0	0	0	0	0	0	0	0	0	0	0	0	0	0	0	0	0	0	0	0	0	0	0	0	0	0	0	0	0	0	0	0	0	0	0	0	0	0	0	0	0	
69	69	69	69	69	69	69	69	55	55	55	55	55	55	55	78	56	59	61	86	86	56	63	0	0	0	0	0	0	0	0	0	0	0	0	0	0	0	0	0	0	0	0	0	0	0	0	0	0	0	0	0	0	0	0	0	0	0	0	0	0	0	0	0	0	0	0	0	0	0	0	0	0	0	0	0	0	0	0	0	0	
0	0	0	0	0	0	0	0	0	0	0	0	0	0	0	0	0	0	0	0	0	0	0	0	0	0	0	0	0	0	0	0	0	0	0	0	0	0	0	0	0	0	0	0	0	0	0	0	0	0	0	0	0	0	0	0	0	0	0	0	0	0	0	0	0	0	0	0	0	0	0	0	0	0	0	0	0	0	0	0	0	
0	0	0	0	0	0	0	0	0	0	0	0	0	0	0	0	54	2	2	61	86	86	86	86	62	0	0	0	0	0	0	0	0	0	0	0	0	0	0	0	0	0	0	0	0	0	0	0	0	0	0	0	0	0	0	0	0	0	0	0	0	0	0	0	0	0	0	0	0	0	0	0	0	0	0	0	0	0	0	0	0	
0	0	0	0	0	0	0	0	0	0	0	0	0	0	0	0	57	54	2	2	61	86	86	86	62	0	0	0	0	0	0	0	0	0	0	0	0	0	0	0	0	0	0	0	0	0	0	0	0	0	0	0	0	0	0	0	0	0	0	0	0	0	0	0	0	0	0	0	0	0	0	0	0	0	0	0	0	0	0	0	0	
0	0	0	0	0	0	0	0	0	0	0	0	0	0	0	0	86	56	54	2	60	61	86	86	62	0	0	0	0	0	0	0	0	0	0	0	0	0	0	0	0	0	0	0	0	0	0	0	0	0	0	0	0	0	0	0	0	0	0	0	0	0	0	0	0	0	0	0	0	0	0	0	0	0	0	0	0	0	0	0	0	
0	0	0	0	0	0	0	0	0	0	0	0	0	0	0	0	86	86	57	56	59	54	55	55	55	0	0	0	0	0	0	0	0	0	0	0	0	0	0	0	0	0	0	0	0	0	0	0	0	0	0	0	0	0	0	0	0	0	0	0	0	0	0	0	0	0	0	0	0	0	0	0	0	0	0	0	0	0	0	0	0	
0	0	0	0	0	0	0	0	0	0	0	0	0	0	0	0	86	86	86	86	57	85	54	2	2	0	0	0	0	0	0	0	0	0	0	0	0	0	0	0	0	0	0	0	0	0	0	0	0	0	0	0	0	0	0	0	0	0	0	0	0	0	0	0	0	0	0	0	0	0	0	0	0	0	0	0	0	0	0	0	0	
0	0	0	0	0	0	0	0	0	0	0	0	0	0	0	0	58	58	58	58	58	57	56	54	2	0	0	0	0	0	0	0	0	0	0	0	0	0	0	0	0	0	0	0	0	0	0	0	0	0	0	0	0	0	0	0	0	0	0	0	0	0	0	0	0	0	0	0	0	0	0	0	0	0	0	0	0	0	0	0	0	
0	0	0	0	0	0	0	0	0	0	0	0	0	0	0	0	0	0	0	0	0	0	0	0	0	0	0	0	0	0	0	0	0	0	0	0	0	0	0	0	0	0	0	0	0	0	0	0	0	0	0	0	0	0	0	0	0	0	0	0	0	0	0	0	0	0	0	0	0	0	0	0	0	0	0	0	0	0	0	0	0	
0	0	0	0	0	0	0	0	26	27	6	26	26	51	37	52	50	49	37	40	43	37	34	32	27	6	32	6	32	6	6	26	0	0	0	0	0	0	0	0	0	0	0	0	0	0	0	0	0	0	0	0	0	0	0	0	0	0	0	0	0	0	0	0	0	0	0	0	0	0	0	0	0	0	0	0	0	0	0	0	0	
0	0	0	0	0	0	0	0	19	27	6	29	31	26	43	44	49	52	36	40	51	34	34	46	27	46	46	46	46	6	32	26	0	0	0	0	0	0	0	0	0	0	0	0	0	0	0	0	0	0	0	0	0	0	0	0	0	0	0	0	0	0	0	0	0	0	0	0	0	0	0	0	0	0	0	0	0	0	0	0	0	
0	0	0	0	0	0	0	0	19	27	6	32	6	26	50	36	36	35	39	42	41	34	26	26	28	31	31	31	31	7	46	26	0	0	0	0	0	0	0	0	0	0	0	0	0	0	0	0	0	0	0	0	0	0	0	0	0	0	0	0	0	0	0	0	0	0	0	0	0	0	0	0	0	0	0	0	0	0	0	0	0	
0	0	0	0	0	0	0	0	26	28	7	29	6	26	49	48	46	46	47	40	52	38	51	26	27	6	6	29	6	30	31	26	0	0	0	0	0	0	0	0	0	0	0	0	0	0	0	0	0	0	0	0	0	0	0	0	0	0	0	0	0	0	0	0	0	0	0	0	0	0	0	0	0	0	0	0	0	0	0	0	0	
0	0	0	0	0	0	0	0	26	27	6	7	29	26	51	48	26	26	7	39	42	41	48	26	27	46	46	6	30	6	46	26	0	0	0	0	0	0	0	0	0	0	0	0	0	0	0	0	0	0	0	0	0	0	0	0	0	0	0	0	0	0	0	0	0	0	0	0	0	0	0	0	0	0	0	0	0	0	0	0	0	
0	0	0	0	0	0	0	0	26	27	6	30	26	26	50	52	36	34	53	28	40	39	41	26	26	26	26	26	31	30	31	26	0	0	0	0	0	0	0	0	0	0	0	0	0	0	0	0	0	0	0	0	0	0	0	0	0	0	0	0	0	0	0	0	0	0	0	0	0	0	0	0	0	0	0	0	0	0	0	0	0	
0	0	0	0	0	0	0	0	0	0	0	0	0	0	0	0	0	0	0	0	0	0	0	0	0	0	0	0	0	0	0	0	0	0	0	0	0	0	0	0	0	0	0	0	0	0	0	0	0	0	0	0	0	0	0	0	0	0	0	0	0	0	0	0	0	0	0	0	0	0	0	0	0	0	0	0	0	0	0	0	0	
0	0	0	0	0	0	0	0	26	27	6	30	6	26	50	52	49	38	45	43	40	44	43	26	27	6	6	5	6	30	6	27	0	26	2	2	17	24	86	86	86	86	86	86	86	86	86	86	86	86	86	86	86	86	86	86	86	86	86	86	86	86	86	86	86	86	86	86	86	86	86	86	86	86	86	86	86	86	86	27	2	
0	0	0	0	0	0	0	0	26	27	30	6	29	26	49	44	46	45	36	39	42	41	27	26	27	32	6	29	30	6	29	4	0	26	25	5	17	86	86	86	86	86	86	86	86	86	86	86	86	86	86	86	86	86	86	86	86	86	86	86	86	86	86	86	86	86	86	86	86	86	86	86	86	86	86	86	10	9	9	2	5	
0	0	0	0	0	0	0	0	26	28	28	28	7	85	36	34	28	43	44	47	40	34	27	26	27	29	30	31	6	6	6	3	0	26	33	2	24	86	86	86	86	86	86	86	86	86	86	86	86	86	86	86	86	86	10	2	2	9	19	86	86	86	86	86	86	86	86	86	86	86	86	86	86	86	86	86	4	6	6	2	2	
0	0	0	0	0	0	0	0	26	27	6	5	29	7	29	34	27	39	42	41	48	38	27	26	27	30	6	6	6	6	28	26	0	26	1	1	1	1	1	1	1	1	1	16	1	16	1	16	1	1	1	16	1	16	1	1	1	1	1	1	16	1	1	16	1	1	16	1	16	1	16	1	1	1	1	1	7	6	15	4	2	
0	0	0	0	0	0	0	0	26	27	6	2	6	5	7	38	27	47	28	37	35	26	26	26	26	26	26	26	28	6	27	26	0	26	2	2	2	2	2	22	15	15	15	15	14	14	14	15	15	15	14	15	15	15	18	18	18	18	18	14	15	15	14	15	15	15	14	15	15	15	15	15	15	14	12	8	15	7	6	3	2	
0	0	0	0	0	0	0	0	26	27	29	6	6	31	29	26	26	34	35	36	35	34	31	26	26	26	26	26	27	6	27	26	0	26	2	21	23	4	2	21	13	13	10	20	16	19	13	13	13	13	13	13	10	19	5	2	5	5	17	13	13	13	13	13	13	13	13	13	13	13	13	13	13	13	11	1	1	1	1	1	1
